OTUid,BOLDid,NTCreads,NTChits,ALLreads,ALLhits,TRUEhits,TRUEreads,NTChitFrac,NTCreadFrac
OTU1,BOLD:AAD6798,3530,2,364109,118,116,360579,0.0169491525423729,0.00969489905495332
OTU10,BOLD:ACF3057,1079,1,166136,42,41,165057,0.0238095238095238,0.00649467905812106
OTU1097,BOLD:AAN5451,106,2,23423,142,140,23317,0.0140845070422535,0.00452546642189301
OTU11,BOLD:AAG3848,5157,2,427016,97,95,421859,0.0206185567010309,0.0120768308447459
OTU1118,BOLD:AAC6596,31,1,99,13,12,68,0.0769230769230769,0.313131313131313
OTU1130,BOLD:AAN4385,20,2,326,15,13,306,0.133333333333333,0.0613496932515337
OTU115,BOLD:AAA4942,1206,1,11608,40,39,10402,0.025,0.103893866299104
OTU117,BOLD:AAH5449,361,1,14072,18,17,13711,0.0555555555555556,0.0256537805571347
OTU1190,BOLD:AAP2734,2633,2,11888,12,10,9255,0.166666666666667,0.221483849259758
OTU12,BOLD:AAE5173,51497,3,536034,38,35,484537,0.0789473684210526,0.0960703985194969
OTU1210,BOLD:AAF4632,57,1,6933,117,116,6876,0.00854700854700855,0.00822154911293812
OTU1237,BOLD:AAC3269,1,1,77,4,3,76,0.25,0.012987012987013
OTU1244,BOLD:AAN5882,997,2,5051,21,19,4054,0.0952380952380952,0.197386656107701
OTU1265,BOLD:AAF4632,12,1,2143,93,92,2131,0.010752688172043,0.0055996266915539
OTU1292,BOLD:AAN5882,50,3,3270,78,75,3220,0.0384615384615385,0.0152905198776758
OTU1296,BOLD:AAD2334,149,1,1555,44,43,1406,0.0227272727272727,0.0958199356913183
OTU1317,BOLD:AAN5451,36,2,2746,145,143,2710,0.0137931034482759,0.0131099781500364
OTU1318,BOLD:ABV9403,2,1,238,21,20,236,0.0476190476190476,0.00840336134453781
OTU1350,BOLD:AAA7067,34,1,9295,83,82,9261,0.0120481927710843,0.0036578805809575
OTU1351,BOLD:AAB7030,10,1,6220,119,118,6210,0.00840336134453781,0.00160771704180064
OTU1393,BOLD:ACD3689,65,1,177,10,9,112,0.1,0.367231638418079
OTU14,BOLD:AAO3940,18773,2,463720,106,104,444947,0.0188679245283019,0.0404834814111964
OTU1401,BOLD:AAF9008,1,1,318,35,34,317,0.0285714285714286,0.00314465408805031
OTU1403,BOLD:ACV0130,2,1,1113,67,66,1111,0.0149253731343284,0.00179694519317161
OTU1412,BOLD:ADD1431,9,1,2288,8,7,2279,0.125,0.00393356643356643
OTU1426,BOLD:ACF7238,148,1,511,2,1,363,0.5,0.289628180039139
OTU1434,BOLD:AAA7067,90,1,1017,63,62,927,0.0158730158730159,0.0884955752212389
OTU1480,BOLD:AAN5882,10,2,694,58,56,684,0.0344827586206897,0.0144092219020173
OTU149,BOLD:AAH4942,524,1,8074,27,26,7550,0.037037037037037,0.0648996779786971
OTU1497,BOLD:AAI1618,3,1,1590,42,41,1587,0.0238095238095238,0.00188679245283019
OTU1508,BOLD:AAI1618,117,1,409,8,7,292,0.125,0.286063569682152
OTU1554,BOLD:AAP2734,189,3,6967,90,87,6778,0.0333333333333333,0.0271278886177695
OTU16,BOLD:AAA7067,8229,2,226627,109,107,218398,0.018348623853211,0.0363107661487819
OTU1656,BOLD:AAD6798,5,1,509,29,28,504,0.0344827586206897,0.00982318271119843
OTU1683,BOLD:AAF4632,9,1,3022,76,75,3013,0.0131578947368421,0.00297816015883521
OTU1693,BOLD:AAP2734,16,2,331,8,6,315,0.25,0.0483383685800604
OTU171,BOLD:AAG2724,1718,1,4422,3,2,2704,0.333333333333333,0.388511985526911
OTU1748,BOLD:ACF8409,22,2,529,56,54,507,0.0357142857142857,0.0415879017013233
OTU1756,BOLD:AAG3848,1,1,518,62,61,517,0.0161290322580645,0.00193050193050193
OTU1782,BOLD:AAO3940,4,2,246,32,30,242,0.0625,0.016260162601626
OTU1794,BOLD:AAD2334,31,1,70,16,15,39,0.0625,0.442857142857143
OTU18,BOLD:ABY8739,4885,1,242522,32,31,237637,0.03125,0.0201425025358524
OTU1819,BOLD:AAE5173,2,1,88,14,13,86,0.0714285714285714,0.0227272727272727
OTU1834,BOLD:AAF4632,2,1,1818,74,73,1816,0.0135135135135135,0.0011001100110011
OTU1871,BOLD:AAG3848,45,2,761,74,72,716,0.027027027027027,0.0591327201051248
OTU1878,BOLD:ABW4215,17,1,618,33,32,601,0.0303030303030303,0.0275080906148867
OTU19,BOLD:AAK8834,33764,4,138736,46,42,104972,0.0869565217391304,0.243368700265252
OTU191,BOLD:ACT5835,2063,1,3813,4,3,1750,0.25,0.54104379753475
OTU2,BOLD:AAH3225,1667,1,212384,40,39,210717,0.025,0.00784899050775953
OTU21,BOLD:ACR3763,3730,1,109723,43,42,105993,0.0232558139534884,0.0339946957338024
OTU212,BOLD:ACE7661,22,1,2683,17,16,2661,0.0588235294117647,0.00819977636973537
OTU214,BOLD:AAW6795,684,1,8068,45,44,7384,0.0222222222222222,0.0847793753098661
OTU221,BOLD:AAA6349,53,1,2845,3,2,2792,0.333333333333333,0.0186291739894552
OTU236,BOLD:AAE1264,1259,2,2225,14,12,966,0.142857142857143,0.565842696629213
OTU29,BOLD:ADD1431,358,1,85962,9,8,85604,0.111111111111111,0.0041646308834136
OTU3,BOLD:AAP2734,21146,2,507569,74,72,486423,0.027027027027027,0.0416613307747321
OTU317,BOLD:ACA8818,107,1,2127,22,21,2020,0.0454545454545455,0.0503055947343677
OTU319,None,78,1,2099,12,11,2021,0.0833333333333333,0.0371605526441162
OTU329,BOLD:AAG0149,640,1,2778,41,40,2138,0.024390243902439,0.230381569474442
OTU339,BOLD:AAM6294,787,1,1940,7,6,1153,0.142857142857143,0.405670103092784
OTU34,BOLD:AAM6211,1210,2,95944,75,73,94734,0.0266666666666667,0.0126115233886434
OTU345,BOLD:ACE7334,173,1,2098,12,11,1925,0.0833333333333333,0.0824594852240229
OTU35,BOLD:ABW4215,4085,1,78781,48,47,74696,0.0208333333333333,0.051852604054277
OTU4,BOLD:AAN5882,11869,3,460953,89,86,449084,0.0337078651685393,0.0257488290563246
OTU40,BOLD:AAC3947,17101,1,33155,4,3,16054,0.25,0.515789473684211
OTU403,BOLD:ABY0555,918,1,990,2,1,72,0.5,0.927272727272727
OTU407,BOLD:AAK8831,5,1,1796,18,17,1791,0.0555555555555556,0.00278396436525612
OTU43,BOLD:ACE2171,20437,3,41521,35,32,21084,0.0857142857142857,0.492208761831362
OTU45,BOLD:ACF0541,9632,1,35939,25,24,26307,0.04,0.268009683074098
OTU5,BOLD:AAN5451,5497,3,888226,172,169,882729,0.0174418604651163,0.00618874025304371
OTU57,BOLD:AAI1618,5300,2,57709,66,64,52409,0.0303030303030303,0.091840094266059
OTU635,BOLD:AAN5882,14,1,8517,52,51,8503,0.0192307692307692,0.00164377128096748
OTU651,BOLD:ACD3689,645,1,799,3,2,154,0.333333333333333,0.807259073842303
OTU672,BOLD:ACI6375,436,1,436,1,0,0,1,1
OTU68,BOLD:AAB7030,3982,1,60257,109,108,56275,0.00917431192660551,0.0660836085434057
OTU691,BOLD:AAC9132,478,1,482,2,1,4,0.5,0.991701244813278
OTU7,BOLD:AAF4632,12019,1,381598,104,103,369579,0.00961538461538462,0.0314964963128738
OTU779,BOLD:ABW9743,18,1,319,9,8,301,0.111111111111111,0.0564263322884013
OTU798,BOLD:AAO3940,62,1,2313,18,17,2251,0.0555555555555556,0.0268050151318634
OTU8,BOLD:AAN4385,40675,3,99272,18,15,58597,0.166666666666667,0.409732855185752
OTU83,BOLD:ABA5203,1111,1,20276,9,8,19165,0.111111111111111,0.0547938449398303
OTU88,BOLD:AAE0434,335,1,20805,66,65,20470,0.0151515151515152,0.0161018985820716
OTU9,BOLD:AAG8502,8840,2,185762,50,48,176922,0.04,0.0475877736027821
OTU907,BOLD:AAO3940,31,1,1336,50,49,1305,0.02,0.0232035928143713
OTU935,BOLD:AAO3940,93,2,2720,45,43,2627,0.0444444444444444,0.0341911764705882
OTU96,BOLD:ACL3138,715,1,14044,6,5,13329,0.166666666666667,0.0509114212475078
